11111111111111111111111111111111
1...............................
1...O....O.....O....O...........
1....1111111111111.........11111
1................1.............1
1....1111111111111.........1.1.1
1111.............1......1111.1.1
1................1......1....1.1
1................1......1.1111.1
11111111111111...1......1....1.1
1............111.1.......111.1.1
1................1.........1.1.1
1..111111111111111.........1.1.1
1..1......................11.1.1
1..1....................111..1.1
1..1....................1...11.1
1..11...................11...1.1
1...1111111111111........1...1.1
1...............1111111111...1.1
1........11111...............1.1
1111111111...11111111111111111.1
1.P........1...................1
1M.........1...................1
11111111111111111111111111111111